R B B B B B B B B B B B B B B B B B B B B B B B B B B B B B B B
R _ _ _ _ _ _ _ _ _ _ _ _ _ _ _ _ _ _ _ _ _ N N N _ _ _ _ _ _ L
R _ _ _ _ _ _ _ _ _ _ _ _ _ _ _ _ _ _ _ _ _ N P N _ _ _ _ _ _ L
R _ _ _ _ _ _ _ _ _ _ _ _ _ _ _ _ _ _ _ _ _ N N N _ _ _ _ _ _ T
R _ _ T T T T T T T T T T _ _ _ _ _ _ _ _ _ _ _ _ _ _ _ _ _ _ L
R _ _ _ _ _ _ _ _ _ _ _ _ _ _ _ _ _ _ T T T T T T T T T T _ _ L
R _ _ _ _ _ _ _ _ _ _ _ _ _ _ _ _ _ _ _ _ _ _ _ _ _ _ _ _ _ _ L
R _ _ _ _ _ _ _ _ _ _ _ _ _ _ _ _ _ _ _ _ _ _ _ _ _ _ _ _ _ _ L
R _ _ _ _ _ _ _ _ _ _ _ _ _ _ _ _ _ _ _ _ _ _ _ _ _ _ _ _ _ _ L
R _ _ _ _ _ _ _ _ _ _ _ _ _ _ _ _ _ _ _ _ _ _ _ _ _ _ _ _ _ _ L
R _ _ _ _ _ _ _ _ _ _ _ _ _ _ _ _ _ _ _ _ _ _ _ _ _ _ _ _ _ _ L
R _ _ _ _ _ _ _ _ _ _ _ _ _ _ _ _ _ _ _ _ _ _ _ _ _ _ _ _ _ _ L
R _ _ T T T T T T T T T T _ _ _ _ _ _ _ _ _ _ _ _ _ _ _ _ _ _ L
R _ _ _ _ N N N _ _ _ _ _ _ _ _ _ _ _ T T T T T T T T T T _ _ L
R _ _ _ _ N P N _ _ _ _ _ _ _ _ _ _ _ _ _ _ _ _ _ _ _ _ _ _ _ L
R _ _ _ _ N N N _ _ _ _ _ _ _ _ _ _ _ _ _ _ _ _ _ _ _ _ _ _ _ L
R _ _ _ _ _ _ _ _ _ _ _ _ _ _ _ _ _ _ _ _ _ _ _ _ _ _ _ _ _ _ L
L T T T T T T T T T T T T T T T T T T T T T T T T T T T T T T R